#####################################################################################################
S:::#     #   #   #:::#   # #:::#:::::::#:::#:::::::#     #     #     #   #         #   # #     #   #
# #:##### ### # ###:#:# # # #:#:#:#####:#:#:#:#####:# ### # ### # ### # # # ##### # # # # # ### # ###
# #:::::::::::::::::#:  #   #:#:#:::  #:::#:#:::#:::# #   # #   # # #   #   #   # #   # # # # # #   #
# ### ############# #:#######:#:###:# #####:###:#:# # # ### # ### # ######### # ### ### # # # # # # #
#   #     #       # #:::::::::#:#:::# # #:::#:::#:#   # #   # # # #       #   # #     #   # #   # # #
### ##### # ##### ####### #####:#:### # #:###:###:##### # ### # # ####### # ### # ####### # # ### # #
# # #           #       #     #:::#   # #:::::# #:#   #   #   #         #   #   #       #   #   # # #
# # ######### ####### # ##### ##### ### ##### # #:# ######### # ####### ##### ### ### ########### # #
#   #       #     #   #     # #   # #   #   #   #:# #         # #     #   # #     # #     # #   # # #
##### # ### # ### # ######### # ### # ### #######:# # ######### # ### ### # ##### # ### # # # # # # #
#   # #   # # #   #     #     #     #   # #:::::::#       #     #   #   #   #   # # # # # #   #   # #
# # # ##### # # ####### # ############# # #:############### ####### ### ### ### # # # # # # ####### #
# #   #     # # #   #   # #   #     #   # #:                # #       #   #     # # #   # #       # #
# ##### ### # # # # # ##### # # ### # ### #:################# # ####### # ### ### # # # # ####### # #
# #   #   #   # # # #       #   #   #   # #:::::::::::::#   #   #     # #     #   # # # # #   #   # #
# # ##### ##### # # ######### ######### # ##### # #####:# ####### # # # # # ####### # ### # ### ### #
# #   #       # # # #   #   #   #       #       #   #:::  #     # # # # # # #   # # #   #   #   #   #
### # # ####### # # ### # # ### # ### ###############:##### ### # # # # # # ### # # ### ##### ### ###
#   #   #     #   #   #   # # #   #   #         #   #:::::# # # # # # # # #       #   #       # #   #
# ##### # ### ####### ##### # ##### ### ####### # # #####:# # # # # # ### ########### ######### ### #
#   # #   #   #     #     # # #   #   #     # #   #    :::  # #   # #   #     #   # #         #     #
### # # ### ##### # ### ### # # # # # ### # # #########:##### ######### ### # # # # ######### # #####
# # #   # #   #   #   #   #   # #   #   # #   #   #    :::#   #   #   #   # # # # # #     # #   #   #
# # # # # ### # ##### ### ### # ####### ####### # # #####:# # # # # # # # # ### # # ### # # ##### # #
#   # # #     #   # # # #   # # #       #       # # #   #:# # # #   # # # #     #   #   # # #     # #
# ##### # ####### # # # # ### # # ####### ####### # # ###:# ### ####### # ### ####### ### # # # ### #
# #   # #       # #   # # #   # #     #   #   # # # # #:::#:::#   #   # # #   #   #   #     # # # # #
# ### # ### ### # ### # # # ### ##### # ### # # # ### #:###:#:### # # # # ##### ### ### ####### # # #
# #   #   #   # # # # #   #   # #   # #   # # # #   # #:::::#:    # #   #       #   #     #     #   #
# # ##### ### ### # # ####### # # # ##### ### # ### # #######:##### ########### # ####### # ### # ###
#   #   #   # #   # # # #   #   # # #   #   # #     #  :::  #:# #   #     #   #         # #   # #   #
### # ### # # # ### # # # # ####### # # # # # ### #####:#:###:# # ### ### # # ######### # # # ##### #
# # # #   # # #     #     #     #   # # # # # #   #   #:#:::#:# #     #   # #         # # # #     # #
# # # # ##### # ############### # ### # ### # # ### # #:###:#:# ####### ### # ####### # # # ####### #
# # #   #   #       #           #     #     #     # # #:::#:::#   #     #   #       # # # #   #   # #
# # ##### # ####### ################# ##### ####### #####:##### # ################### # ##### # # ###
# # # #   #   #   #             #     #   # #       #   #:::#   #     # #   #     #   #     #   #   #
# # # # ####### # ########### # # ####### ### ####### #####:# ####### # # # # ### # ####### ####### #
#   # #   #     #     #   #   # # #     #     #     #  :::::#   #     #   # # # # #         #   #   #
# ### ### # # ##### ### ### ### # ##### # # ##### # ###:####### # ######### # # # ########### # # # #
# #   # #   # #   #     #   #   #     #   #   #   #   #:::#     #:::::::#:::::#   #   #       # # # #
# # # # ##### # ######### ### ##### ######### # #########:#######:#####:#:###:####### # ####### ### #
# # # #     # #   #         #     # #         # #   #   #:::#:::#:#   #:#:::#:::        #     #     #
# # # ##### # ### ### ##### ##### # # # ####### # # # # ###:#:#:#:# ###:###:###:############# #######
#   #       #   # #   #   #   #   #   #         # #   # #:::#:#:::#   #:::::# #:::::::::::::::::    #
# ############# # # ##### ### # ### ############# ##### #:###:####### ##### # ########### #####:### #
# #   #       #   #       #   #   #   #           # #   #:::::#     #     # #       #     #:::::#   #
# # ### ##### ### ### ### # ##### ### # # ######### # ######### ### ##### ##### # ### #####:#########
# # #   #   #     #   #   # #     #   # #         # # #   #   # #   #   #     # #   # #:::#:#       #
# # # ### # # ##### # # ### # ### # ####### ##### # # # # ### # # ### # ##### # ### # #:#:#:# ##### #
# # # #   # #       # # #   # # #   #   # #   #   # #   #   # # #   # #           #   #:#:::#   #   #
# # # # ############# ### ### # ##### # # ### # ### ####### # # ### # ############### #:####### # ###
#   # #             #   # #   #       # #   # #     #     # # # # #       #         # #:    #   #   #
##### ############# # # # ############# ### # ####### ##### # # # ######### ####### # #:### # ##### #
#   #   #     #   #   # #   #   #       #   #   #   #       # # #         # #     #   #:#   # #   # #
# # ### # ### # # ##### ### # # # # ##### # ### # # ##### ### # ######### # # ### #####:##### # # ###
# #   #   #   # # #     #   # #   # #     #     # #     # # # # #   #     #   #   #    :::    # #   #
# ######### ##### # ##### # # ##### # ########### ##### # # # # ### # ####### # #########:##### ### #
# #     #       #       # # # #   # #             #   # #   # #   # #     #   #         #:    # #:::#
# # ### # ### # ######### ### # # ############# ### # # ##### ### # # # # ###############:### ###:#:#
# # #   # #   # #   #     #   # #   #         #   # # # #   #     # # # #   #   #   #  :::  # #:::#:#
# # # ### # ### # ### ##### ### # # # ### ### # ### # # # # # ##### # ##### # # # # # #:### # #:###:#
#   #   # # #   #   #     #   # # # # # # #   #   # # # # # #   #   # #       #   #   #:#   # #:#:::#
####### # # # ##### ### # ### ### # # # # # ##### # ### # # ### # ##### ###############:# #####:#:# #
# #   # # # #     # # # # #   #   # # #   # #   # #     # #   # # #     #     # #   #:::# #:::#:#:# #
# # # # # # ### # # # # # # ### ### ### ##### ### ##### # ### ### ####### ### # # # #:### #:#:#:#:# #
# # # #   # #   #   # # #   #   #     #     # #   #   # # # #     #     # #   #   # #:#   #:#:::#:# #
# # # ##### # ####### # ##### ####### ### # # # ##### # # # # ##### ### # ####### # #:#####:#####:# #
#   #     # #     #   #     # #     # #   # # #   #   # # # # #     # #   #     # # #:::::::#:::::# #
####### ### # ### # # ##### # # ### # # ### # # # # ##### # ### # # # ### # ### # # # # # ###:#######
#     # #   # #     #     # # # #   # #   # # # #   # #   #   # # # #     # #   # # # # #   #:#     #
# ### # # # # # ####### # # # ### ### ### # # # ##### # ##### ### # ### ### # ### # # #######:# ### #
# #   #   # # # #     # # #   #   # #   # #   #     #   #   #     # #     # #     #   #     #:#   # #
# ##### ### # ### ### # # ##### ### # ### ######### # ### # # ##### # ### ####### ##### ### #:##### #
#     #   # # #   #   # #       #     #   #   #   #     # # # #     # #   #     #   #   # # #:  #   #
##### ### ### # ##### # ##### # # ##### ### # # # # ##### # # ######### ### ### ### # ### # #:# # # #
#   #   #   #   #     #   #   # #     # #   #   #         # #         #     # # # # # # #   #:# # # #
# # # # ### ##### ### ### # ### ##### # # ### ############# ######### ####### # # # # # #####:# # # #
# # # # #   #   #   #   # #   #   #     # #     #         #     #   #     # #   # #   #:::::::#   # #
### # # ##### # ### ### # ##### # ####### # ### # ####### ##### # ####### # # ### #####:########### #
#     #     # # # #   # # #   # #     #   #   # #   #   #     # # #     # # # # #  :::::  #     # # #
# ######### # # # ### # # # # ####### # ##### ##### # # # ### # # # ##### # # # ###:##### # ### # # #
# #       #   #     # # # # # #   #   # #   #     #   # # #   #   #     #   #     #:::# #   # # # # #
# # # ############# ### # # # # # # ### # # # ### ##### # # ### ####### ##### ### ###:# # ### # # # #
# # # #     #   #   #   # # # # # #     # # #   #     # # #   #   #   #     # # #  :::#   #     # # #
# # ### ### # # ##### ### # ### ######### # ### ##### ### ### ##### # ##### # # ###:####### ##### # #
# #     #     #     # # # #   # #       # #     #   #       #       #     # #   # #:::::::# #:::#   #
# ####### ######### # # # # # # # ##### # ### ### # ####################### # ### #######:###:#:#####
#   #         # #   # #   # #     #   #   #     # #       #         #       #     #   #  :::::#:#   #
### # ##### # # # ##### ### ##### # # ##### ##### ####### # ####### # # ########### # #########:# # #
#   # #     #   # #     #   # #   # # #     # #     #     # #     # # # #       #   # #   #:::::# # #
# ##### ######### ########### # ### # # ##### # ### # ##### # ### # # # # ####### ##### # #:####### #
#     # #       #       #       #   #   #       #   # #     # #   # # # #       # #     #  :::::::# #
##### # # ########### ### ####### ####### ####### ##### ### # # ##### # ####### # # #############:# #
#   #   #   #           # # #     #     #       # #     #     #       #   #   # #   #   #   #  :::# #
# # ##### # # ######### # # # ##### ### ####### # # ##### ########### # ### # # ####### # # # #:### #
# # #   # #   #       # # # # #     #   #     # #   #   # #         # #     # #   # #     #   #:::# #
# # # # # ##### ##### ### # # # ##### ##### # # ##### # # # ####### # ####### ### # # ###########:# #
# #   #         #         #         #       #   #     #     #       #       #     #             #:::G
#####################################################################################################
