#####################################################################################################
S:::::#   #   #:::::#:::#:::    #     #   #             #   # #   #   # #           #   #           #
#####:# ### ###:###:#:#:#:#:### # ### ### # ######### # # # # # # # # # # ######### # ### ######### #
#   #:#   # #:::  #:::#:#:#:  #   #   #   #       # # # # # # # #   # #         # #     #       #   #
### #:# # # #:#########:#:#:# ##### ### ######### # # # # # # # ##### ######### # ##### ####### # ###
#   #:# # # #:  #      :::#:# #   #   # #     #   #   # # # # #     #           #   # # #     # # # #
# ###:# # # #:# # #########:# # ##### # # ### # ######### # # ### # ### # ######### # # # # # ### # #
#   #:# #   #:# # #       #:# #     #   #   #   #       # # #   # #   # # #   #     # # # # #   # # #
# ###:### ###:### # #######:# ##### ####### ##### ##### # # # # # ### # # # # # ##### # # # ### # # #
#    :::#    :::#   #    :::# #   #   #   #       #   #   #   # # #   # #   #   # #   #   #   # # # #
#######:#######:#########:### # # ### ### ### ##### ########### # ############### # ### ##### # # # #
#      :#:::::#:#     #:::  #   #     #   #       #   #   #   # #           #     #     #     #   # #
# #####:#:###:#:# ### #:### ########### ######### ### # # # # # ### ####### # ### # # ############# #
#     #:::#  :::# # #  :#   #:::#:::::::#         # # # #   #   #   #   #   # # #   #   #         # #
##### ######### # # ###:#####:#:#:#####:# ### ### # # # # ######### ### # ### # # ####### # ### # # #
# #   #       # # #   #:::::::#:#:# #:::  #   #   # # # # #       #   # #   #   # #     # # #   #   #
# # ### # ### # # ### ### ### #:#:# #:############# # # ### ##### ### # ### # ### # ### # # # #######
# # # # #   #   #     #   #   #:::# #:#   #       # # # #   #     #   #     #   #   # #   # #   #   #
# # # # ### ##### ######### # ##### #:# # # ##### # # # # ### ##### ################# ########### # #
# # # #   #     #       #   #       #:# #   #   # # # # # # #     #     #     #     #   #     #   # #
# # # ### ############# #############:# ##### # # # # # # # ##### ### # # ##### ### ### # # # # ### #
#   #             #   # #     #     #:#     # #   # # #   #     #   # #         # # # # # # # #   # #
# ############# # # # # # ### ##### #:##### # ##### # # ####### ### # ########### # # # # # ##### # #
# #     #       # # #   #   #   #:::::      #   #   #         #   # # #       #   #   #   #       # #
# # ### # ####### ############# #:############# # ### ########### # # # ##### # ##### ############# #
# # #   #       # #           # #:::::#:::::#   #   #           # # #   #   # #   #   #       # #   #
# # ######### ### # ######### # #####:#:###:####### ########### # # # ### ### ### # ### # ### # # ###
# #   #   #     #   #   # #   #     #:::# #:::::#     #     #   #   #   #   #   # #     #   # # # # #
# ### # # ##### ##### # # # # # ######### #####:# ### # ### ######### # ### # # # # # ##### # # # # #
#   #   #     # #   # #   # # #   #:::#:::# #:::#   # #:::# #         #   # # #   # # #     #     # #
########### ### # # # ##### ##### #:#:#:#:# #:####### #:#:# # ########### # # ##### # # ######### # #
#   #       #   # # # #   # #     #:#:::#:::::#:::::::#:#:#   #       #   # # #   # # #       # # # #
# # # ### ### ### # # # # # # #####:###########:# ###:#:#:##### ##### # ### # # # # ######### # # # #
# # #   #     # # #   # # # #     #:#:::::#:::::#   #:::#:#   #   # #       # # #   #   #       #   #
# # ### ### # # # ##### # # ##### #:#:# #:#:#############:# # ### # ######### ####### # ### #########
# #     # # # #     #   # #   #   #:::# #:#:::#       #:::# # # # # # #     #     # # #           # #
######### # ### ##### ### ### # #########:###:####### #:##### # # # # # ### ##### # # ########### # #
#         #     #   #   # # #   #:::::#:::#:::#       #:::    # # # # #   # #     # #     #   #   # #
# ### ##### ### # # ##### # #####:###:#:###:### #########:##### # # # ### ### ##### ### # ### # ### #
#   #     #   #   #   #   # #   #:# #:::#:::  #         #:#:::#   # # #     # #     #   #     #     #
### ##### # # ######### ### # # #:# #####:### ######### #:#:#:##### # # ### # # ############# #######
#     #   # # #         #   # # #:#   #:::#   #       #  :#:#:#       # #   # #   #     # #   #     #
# ### # ### # ##### # ### ### # #:### #:# # ### ##### # #:#:#:# ##### ### ### ### # ### # # ### ### #
# #   # #   #       #   # #   # #:::#:::# #     #   # # #:::#:# #   #   #     #   #   #   #   # # # #
# ##### # # ############# # ##### #:#:### ####### # # #######:### # ### ####### ##### ### ### # # # #
# #   # # #   # #         #     # #:::#   #   #   #     #   #:    #   # #   #   # #     #   # # #   #
### # # ### # # # # ########### ####### ### # # ####### ### #:####### # # # # # # # ######### ### ###
#   #   #   #   # # # #   #   #       # #   #   #       #   #:::    #   # # # #   #         #   #   #
# ####### ### ### # # # ### # ####### # # ####### ##### # #####:### ##### # # # ########### # # # # #
# #         # #   #     #   # #     #   #       #   #   #   # #:::# # #   #   #       #     # # # # #
# # # ####### # # ####### ### # ### ######### ##### # ### # # ###:# # # ####### ##### # ##### # # ###
#   # #       # # #   #   # # #   #           #     # #   # # #:::# # # #       #   # #     # #     #
##### # ####### # ### # ### # ####### ######### ####### ### # #:### # # # ######### # ##### # ##### #
#     #     #   #       #   # #   #   #               # # # # #:::# #   #       #   #     # # #   # #
# # ####### # ########### # ### # # ### ### ######### # # # # ###:# ##### ##### # ####### # # # # ###
# # #   #   # #         # #   # # #   #   # #   #   # #   # # #:::#     #   # # #         #   # #   #
# # # # ##### ### ### # # ### # # ### # # # # # # ### # ### # #:# ##### ### # # ########### ### # # #
# #   #     # #   #   # #   # # # #   # # #   # #     #   # #  :# #   #     # #   #       #     # # #
# # ####### # # # ### ### ### # ### ### # ############# # ### #:# # # ####### ### # # # ########### #
# # #       #   # #   #   #   #     #   #           #   #     #:#   # #     #     # # #   #   #   # #
# # # # # ##### # # ### ### # ####### ############# ##### ### #:##### ### # ######### ### # # ### # #
# # # # # #     # #     #   #   #     #   #   #   #     #   # #:#     #   #     #     #   # #   #   #
# # # ### # ##### ############### ##### # ### # ####### ### ###:# ### # ### ### # ####### # ### #####
# # #   #   #   #     #   # #     #   # # #   #   #   #   #   #:#   #   # #   # # #   #   #   #     #
# # ### ### # ####### # # # # ##### # # # # ##### # # ### ### #:### ### # ### # # ### # ########### #
# #   #   # #       # # #   #       # # #   #     # # # #   # #:#   #   #     # #     #     #       #
# ####### ######### # # # ########### # ### # ### # # # # # ###:# ########### ####### ##### # #######
# # #   #   # #     # # # #   #       #   # #   # # #   # # #:::#   #       #       # #     #     # #
# # # # ### # # ##### ### # ### ##### ### # ### # # # ### # #:####### ### ####### # ### ### # ### # #
#   # #   #   #   #       #         # #   # #   #   #     # #:::::#   #   #       #   #   # #   #   #
### ##### ####### # ############### # # ### # ### ####### # #####:# ### ### ######### ### ##### ### #
#         #   #           #         # #   #   # #       # #     #:#   # #   #       #   # #   #   # #
# ######### # # ######### # ####### # ### ##### ####### # ##### #:### ### # # ##### ##### # # ### # #
# # #   #   #   #         # #     # # # # #   # #   #   #     # #:::#     #   #:::#       # # #   # #
# # # ### ####### ##### ### # ### # # # # ### # # # # ######### ###:### # #####:#:########### ##### #
# #     # #     #     #   #   # # # #   #     #   #   #   #     #:::#   #   # #:#:::#       # #     #
# ##### # # ### ##### ######### # ####################### # #####:######### # #:###:####### # # #####
#     #   # # #   #         #   #   #     #   #   #     #   # #:::#  :::::#   #:#:::  #:::::::#   # #
# ### ##### # ### ##### ##### ##### # ### ### # # ##### ##### #:#####:###:#####:#:### #:#####:### # #
#   #   #   # #   #   #       #   # #   #   # # # #   # #     #:::#:::#:::#   #:#:#   #:::::#:  #   #
####### # ### # ### # ### ### # # # ####### # # ### # # # ##### #:#:###:##### #:#:# #######:#:### ###
#       #   #   #   # #   #     # #   #   # # #     # # # #     #:#:::#:::#:::#:#:# #:::::::#:#   # #
# ##### ### ######### ##### ######### # # # # ####### # # #######:###:# #:#:#:#:#:###:#######:# ### #
#     # #   #   #   #   #     #     #   #   #   #   # # #     #  :::::# #:::#:::#:::#:::::# #:#     #
# ### ### ### # # # ### # ### # ### ########### # # # # ##### # ##### # ###########:### #:# #:##### #
# # # #   #   #   #   #   #     #   #     #   #   #   #   #   # #     #     #:::#:::#   #:# #:::  # #
# # # # ##### ####### # ######### ### ### # # # ####### # # ##### ###########:#:#:### ###:# ###:### #
# #   # #     #     # # #     # # #     # # #     #   # # #   #   #     #:::::#:#:::#   #:#:::#:    #
# ### # # ##### ### # # # ### # # # ##### # # ### # # # # # # # ##### # #:### #:###:### #:#:#:#:#####
#   #   #     # # # # # # # #   # # #   #   #   #   #   #   # #   #   # #:# # #:::#:# # #:#:#:::    #
### # ### ### # # # # # # # ##### # ### # ##### ### # ####### ##### #####:# # ###:#:# # #:#:####### #
#   # #   #   # #   #     #     #   #   # #   #   # # #     # #   # #:::::#   #  :::#   #:#:#:::  # #
####### ### ### ############### ##### ##### # ### # # # ### ### # # #:###################:#:#:#:### #
#   #   # #   #     #         # #   #       #     # # #   #     #   #:#:::::::#:::::::::::#:#:#:::# #
# # # # # ### # # ### ##### # # # # ################# ### ###########:#:#####:#:###########:#:###:# #
# # # # #   # # #   # #     # #   #   #         #   #     #   #     #:::#   #:#:# #    :::::#:::#:# #
# # ### ### # # ### # # ##### ### ##### ### ### ### ####### # # ### # ### # #:#:# # ###:# #####:#:###
# #   #   #   #   #   #     #     #     # #   #         #   # # # # # #   # #:#:# # #:::#   #:::#:::#
# ### # ################# # ####### ### # # ############# ### # # # # # ### #:#:# # #:#######:#####:#
#   #                     #         #   #                 #   #   #   #   #  :::#   #:::::::::#    :G
#####################################################################################################
