#####################################################################################################
S:# #:::# #:::#     #     #     #       #   #         #       # #       #   #           #     # #   #
#:# #:#:# #:#:# ### ### # # ### # ##### # # # ####### # # ### # # ### # # # ### ####### ### # # # ###
#:# #:#:::::#:::::#   # # # # # #   #   # # #   #   #   #   #   # # # #   #   # #     #     # # #   #
#:# #:###########:### # ### # # ### # ### # ##### # ########### # # # ####### # # ### ####### # ### #
#:#:::#       #:::  # #       # #   #     #     # #     #         #   #     #   #   #   # #   #     #
#:#:### #######:### # ######### # ####### ##### # ##### # # ########### ### ##### # ### # # ### ### #
#:#:::  #:::::::# # # #         # #       #   #   #       #   #   #     #   #     # # # #   #   #   #
#:###:###:####### # # # ### ##### # ######### ### ########### # # # ##### ### ##### # # ##### #######
#:::::#:::#     #   #   #         #           # #       #   # # #   # #   # #   # # #     #   #   # #
#######:####### ############# ################# ### ### # # ### ### # # # # # # # # # ### # ### # # #
# #   #:::::::::::::::#       #                 #   #   # #     #   # # # # # # #   # #   #     # # #
# # # # ### #########:# ####### ############### # # ### # ########### # ### # # ##### # ######### # #
# # # #   # #       #:#       #   #:::::#   #   # # #   #     #   #   #   # # # #   # # #   #   # # #
# # # ### ### ##### #:#############:###:### # ### ### ####### ### # ### # # ### ### # # ### # # # # #
# # #   # #   #     #:::::::::#:::::# #:::# # #     #   #         #     # #   # #     #     # #     #
# # # # # # ### #############:#:##### # #:# # # ### ### # # ############# # # # # ################# #
#   # #   # #   # #     #    :#:#   #   #:#   # #     #   # #         # #   #   # #       #   #   # #
##### ### # # ### # ##### ###:#:### #####:# ##### ########### ####### # # # ##### # # ### # # # # # #
# #     # # #   # # #   #   #:#:#     #:::#       #         # #     # # # #     #   #   # # #   #   #
# # ### # ### # # # # # ### #:#:# #####:######### # ####### # # ### # # # ############### # # #######
#   #   #   # # #     # # # #:#:#    :::#     #   # #   #   # #   #   # #   # #     #     # #       #
########### # ### ##### # # #:#:#####:####### ##### # ### ### ######### ### # # ### # ##### ####### #
#       # #   #   #   #     #:#:::::#:#:::::#       #     # #   #     #     #   # # #     # #     # #
# ##### # # # # ### # # #####:#####:#:#:# #:##### ######### # # # # # ####### ### # # ### # # ##### #
# #     # # # # #   #   #   #:::::::#:::# #:    #   #     # # #   # #   #     #   #   # # # # #   # #
# # ##### # ### # ####### # ############# #:####### # # ### ####### ##### ##### # # ### # # # # # # #
# #       # #   #     #   #             # #:#:::# # # #   #     #   #   #       # # #   # # # # #   #
# ########### ### ### # ####### ####### # #:#:#:# # # ### ### # # ### # ##### # # ### ### # # # #####
# #     #     #   # #   #   #   #       # #:::#:::#     # #   # #     #     # # #     # #   #   #   #
# # ### # ##### ### # ### ### ##### #############:##### # # ### ########### # ######### ######### # #
# #   #   #         # #       #         #:::::# #:#     # # # # #   #     # # #   #     #   #   # # #
# # ################# # ######### ##### #:# #:# #:# ##### # # # # ### ### # ### # # ##### # ### # # #
#   #   #             #     #     #   # #:# #:::::# #   # #   # #     #   #     #   #     #   #   # #
##### # ############# ##### # ####### # #:######### # # ##### # # ##### ######### ### ##### # ##### #
#     #         #     #     #   # #     #:#:::#:::# # #   #   #   #     #       # # # #     #       #
# ############# # ##### ####### # # #####:#:#:#:#:# ##### # # ##### ##### # ### # # # ###############
#     # #     # #     #   #     #   #  :::#:#:::#:#     #   #   # #       #   #     #           #   #
##### # # ### # ### ####### # #########:###:### #:##### ####### # ########### ######### # ##### # ###
#     #     # #   # #       #       #:::#:::  # #:::  #         #:::::::::::# #   #   # # # #   #   #
# ######### # ##### # ### ##### ### #:###:##### ###:#############:### #####:# # # # # # # # # ##### #
#       #   #       #   # #     #   #:#:::    #   #:#:::::::::::::  #   #:::    # # # # #   #     # #
####### # ############### ### ### ###:#:##### #####:#:##### ### ### ### #:####### # ### # ####### # #
# #     # # #       #   #   # # #   #:::#   # # #:::#:::#   #   #   #   #:# #   # # #   #       #   #
# # ##### # # ### # # # ### # # ### ##### # # # #:#####:# ### ######### #:# # # # # # ######### ### #
#   #   # #   #   # # #   # #   #   #     # # # #:::#:::#   #   #       #:::::# # #   # #       #   #
# ##### # ### # ##### ### ####### # ### ### # # # #:#:######### # ###########:# ####### # ###########
# #   #       # #       #     #   #   # #   #   # #:::#         # # #:::#:::#:#         # #         #
# # # ######### # ############# ##### ### ########### ### ####### # #:#:#:#:#:######### # # ##### ###
#   # # #     #   #   #   #   # #   #   #           # #   #     #   #:#:::#:::        #   #   # #   #
# ### # # ### ##### # # # # # # # # ### ########### ### ### #########:######### ##### ####### # ### #
#   # #   #   #   # # # #   # #   #   #     #   # #     # #   #     #:#  :::::#     #           #   #
### # # ### ### # # # # # ### # # ######### # # # ####### # # # ### #:###:# #:################### ###
#   #   #   #   #   #   #   #   #   #   #   # # #         # #   #   #:::::# #:#         #       #   #
# ####### ########### ############# # # # ##### # # ############# # ##### # #:# ####### # ### # ### #
#   #     #           #     # #   # # #   #   # # #       #   #   #       # #:#   # #   #   # #   # #
### # ##### # ######### ### # # # # # ##### # # # ### ### # # ############# #:### # # ####### ##### #
#   #       # #       # #   #   #   # #     #   # # #   # # #   # #     #   #:#   #   #     # #   # #
# ############# ##### # # ### ####### # ######### # ### # # ### # # ### # ###:# ### ### ### # # # # #
#     #       # #       # #     #   # #   #   #   #     # #   #   #   # #   #:# # #     #   # # #   #
### # # ##### # # ####### # ##### ### # ### # # ##### ### ### ### ### ##### #:# # ####### ### # #####
#   #   #   #   # #   #   #   #   #   #     # #   #   #   # #   # #   #   # #:#   #   #     #   #   #
# ### ### # ##### # # # ##### # ### ### # ####### # ####### ### ### # # # # #:####### ##### ##### # #
#   # # # # #   # # #   #     #       # #         #     #   # #     # # # # #:::  #   #   #   #   # #
### # # # # # # # # ####### ######### # ### # # # ##### # # # ### # # # # # ###:### ### # ### ##### #
#   #   # # # # # #       #   #     #   #   # # #     #   #   #   # # # # #   #:    #   #     #     #
####### # # # ### # ### # ### # ### # ####### # ############# ##### # # # #####:##### ######### #####
#       # # #     # #   #   # #   # # #     # #   #         #     # #   #     #:    #         # #   #
# ####### # ####### # ##### ####### # # ### # ### # ############# ##### ##### #:### ######### # # ###
#   #     #   # #   # #   #         #   #   #   # # #     #     # #   #     # #:#     # #     # #   #
### # ####### # # ### # # ############### ##### # # # # # # # # # # # ##### ###:# ### # # ##### ### #
#   #     # # #   #   # #     #   #     #   #   # # # # # # # #   # #   #   #:::#   #       #   #   #
# ### ### # # ##### ### ### # ### # ### ### # ##### # # ### ######### # # # #:# ############# ### ###
#   # #   #   #   # #   #   #       #   # # #     # # # #       #   # # # #  :# # #         #   # # #
# # ### ####### # # # ### ########### ### # ##### # # # # ####### # ### # ###:# # # ####### ### # # #
# #   #     #   #       # #     #   #   # #     # # # #   #   #   #     # #:::#   #     # #     # # #
##### ##### # ########### # ### # # ### # # # # # # # ####### # ##### ### #:######### # # ### # # # #
#   # # #   # #         #   # #   #   #   # # # #   # #         #   # #   #:::::::::# #   #   #     #
# # # # # ### # ####### # ### ####### ####### ######### ######### # # # ### # #####:### ### #########
# #   # #     #   #     #   #     #   #   #   #   # #   #   #     # # #   # # #   #:::  #     #     #
### # # ### ##### # ####### ##### # ### # # ### # # # ### # ####### # ### ### # # ###:####### # ### #
#   #   # #   #   #       # #   #   #   # #   # #   #   # #   #   # # # #   # # #   #:::::  # #   # #
# ####### # ### ########### # # ######### ### # # ### ### ### # # # # # # # ### ### #####:# ####### #
#   #     #   #   #   #     # #     #   #   # # # #   #   #   # # #   #   # #     #     #:#         #
# # # ### # # ### # ### ##### # ##### # ### # # # # ### ### ### # ######### # ### # ### #:###########
# #   #   # # #   #     #   # # #     #   #   # #       #   # # # #         #   # # # # #:  # #     #
####### ### ### # ##### # # # # # ####### ### # ############# # ### # ######### ### # # #:# # # ### #
#     # # #     #     # # #   # # #   #   #   # #   #     # #   #   #           #   #   #:# #   #   #
# ### # # ### # ####### # ##### # # # # ### ### # # # ### # # ### # ############# #######:# ##### ###
# #   # #     # # #     # #     #   # # #   #   # # # #     #     #     #     #   #     #:#     #   #
### ### ####### # # ##### ########### # # ### ### # # # ############### ##### # ### ### #:##### ### #
#   #   #   #   # #   #     #     #   # #   # # # # # #           #   #     # #     #   #:# #       #
# ### ### # ### # ### # ### # # # ##### ### # # # ### ########### # # ##### # ####### ###:# # #######
#     #   #     # #   # #   # # # #   # #   #   #     # #       # # #     # #     #     #:#   #     #
####### ######### # ### # ### # ### # # # ### ######### # ### ### ####### # ##### # #####:##### ### #
#       #       #   #   # #   #   # #   #   # #       #   # #     #     # # #   #   #  :::    # #   #
# ####### ##### ### # ### # ##### # # ##### # # ##### ### # # ##### # ### # ### ### # #:##### # #####
# #     #     # #   #   #   #     # # #   #   # #   #   # #   #   # # #   #   #   # # #:#:::# #     #
# # ### ##### ### # ######### # ### # # # ####### # ### # ##### # ### # ##### ### ### #:#:#:####### #
#     #     #     #           #     #   #         #             #     #         #     #:::#:::::::::G
#####################################################################################################
