###################################################
S:      #   #             #   #             #     #
#:##### ### # ########### # # # ########### # ### #
#:# #       # #         #   # #   #   #     #   # #
#:# # ####### # ####### ##### ##### # # ####### # #
#:# # #   #       # #   #     #     # #   #   # # #
#:# # # # # ##### # # ### ####### ### # # # # # # #
#:#   # # #     #   #   #       # #   # # # #   # #
#:# # ### ##### ### ### ####### # ##### # # # ### #
#:# #   #       #   #   #   #   #       # # # #   #
#:# ### # # ############# # # ########### # # # ###
#:# # #   #   #     #     # # #   #       # # # # #
#:# # ### ##### # # # ##### ### # # ####### # # # #
#:#   #   #   # # #   #   #   # # #       # # # # #
#:### ##### # ### ### # # ### # ######### # ### # #
#:#         #   # #   # #   # #       #   # #     #
#:# ########### # # ### ### ### # ### ### # # #####
#:# #       #   # #   #   # #   #   #     # #     #
#:# # ### # # ### ### ### # # ##### # ##### ##### #
#:# #   # #     #   # #   #   #     # #   #   #   #
#:# ##### ##### ### ### ####### ####### # ### # ###
#:# #   #     #   #     #   #   #       #     # # #
#:# # # ##### ########### # # # # ####### ##### # #
#:#   # #   #   #   #     #   # #       # #     # #
#:##### # ### # # # # ######### ####### # # ##### #
#:#     #   # #   #   #     #   #     # # #       #
#:# ####### ####### ### ### ##### # # ### #########
#:# #     # #     #   #   # #     # #     #       #
#:# # ### # # # # ### # # # # ##### ##### # ##### #
#:# # #   #   # #     # # #     # #     # #   #   #
#:# # # ####### ######### ##### # ##### # # ### # #
#:#   #       #         # #     #       # #   # # #
#:# ### ####### ### ### # ############### ### # ###
#:# #     #   #   #   #   #             #   # #   #
#:# ##### # # ### ######### ##### # ######### ### #
#:# #   #   # #   #   #     #   # #     #     # # #
#:# # ####### # ### # ####### # ####### # ##### # #
#:#   #       # #   #   #     # #       #       # #
#:##### ####### ### # # # ### # # ########### # ###
#:#   # # #         # #   #   #   #   # #   # #   #
#:# # # # # ##### ######### ######### # # # # ### #
#:# #   # #   #   #     #       #   # #   #   #   #
#:# ##### # ### # ##### # ##### # # # ### ##### ###
#:# #   #   #   # #     # #     # # #     #   # # #
#:# # # ##### ##### ##### # ##### # # # ### # # # #
#:# # #     # #   # #     #       # # #     # # # #
#:# ### ### # ### # # ########### # # ####### # # #
#:#     #   #     #   #           #   #       #   #
#:############################################### #
#:::::::::::::::::::::::::::::::::::::::::::::::::G
###################################################