###################################################
S:::::#   #:::::::::    #        :::::#:::::#     #
#####:### #:##### #:### # #######:###:#:###:### ###
#:::::#   #:# #   #:#   #   #:::::# #:::#:::  #   #
#:##### ###:# # ###:# # #####:##### #####:### ### #
#:::::#:::::#   #:::# # #:::#:# #   #    :# #   # #
### #:#:##### # #:### # #:#:#:# # ### ###:# # # # #
#   #:::  #   # #:#   # #:#:::# #     #:::#   # # #
########### #####:#######:# ### ##### #:######### #
#     #   # #   #:::::::::# #   #   # #:::#       #
# ##### # # # # ############# ### # ### #:# #######
# #     # # # # #   #       # #   #   # #:#       #
# ### ### # # # # # # # ### # # ##### # #:### # ###
#     #     # #   #   # #   # #     # # #:::# #   #
# ########### ######### # ### ####### # ###:##### #
#     #       # #       #   #      :::#   #:::#   #
### # # ####### # # ###############:#:#######:### #
#   # # #       # #   #           #:#:#:::::::    #
# ##### # ####### ### # # ####### #:#:#:### ##### #
#   #   #       # # # # #   #     #:#:::  #     # #
# ### ####### ### # # # ### # #####:##### ##### # #
# #   #       #     # #   # #   #:::    #   #   # #
# # ### ####### ##### # # # #####:##### ### # #####
# # #   #   #   #   # # # #      :# #   #   # #   #
# # # # # # # ##### ### # #######:# # ####### # # #
#   # #   #     #   #   #     #:::# #   #     # # #
##### ######### # ### ####### #:# # # # # ##### # #
#   # #       # # # # #   #   #:#   # # #       # #
# # # # ##### ### # # ### # ###:####### ######### #
# #   #   #   #     #   # #   #:::::::#       # # #
# ### ### # ### ####### # ###########:####### # # #
# #   #   #           # #     #     #:::# #   # # #
# ####### # ########### ### # # ### ###:# # ### # #
# #       # #       #   #   # #   #   #:#   # #   #
# # ######### ##### # # # ### # # ### #:##### #####
#   #         #   #   #   #     #   # #:#:::::#   #
##### ######### # ############### # ###:#:###:### #
# #   #   #   # #       #     #   # #:::#:  #:::# #
# # ### ### # # # ##### # ### # ### #:###:#####:# #
#   # #     # # #     # # # # # #   #:::::#  :::  #
### # ####### # # ### ### # # ### ######### #:#####
#   #           #   #   # # #     #     # # #:::::#
# ######### ####### ### # # # ##### ### # # #####:#
# #       # #   #   # #     #     # #   #   #   #:#
# # ##### # ### # ### ############# # # ##### # #:#
# #   #   #   # #   #   #           # #       #  :#
####### ##### # # ##### # ####### ### ######### #:#
#     #       # #       # # #   #   # #   #   # #:#
# ### # ####### ######### # # ##### # # ### # ###:#
#   #   #                   #       # #     #    :G
###################################################
