###################################################
S     #           #         #       #       #     #
### # # ##### ##### # ##### # ### # # ##### # #####
#   # #     #     # #   # # #   # # # #   # #     #
# ######### ##### ##### # # ### # # # ### # ##### #
#   #     #   #     # # #   #   # #   #   # #   # #
### # # # ### ##### # # ############### ### # ### #
# #   # #     #   # #         #     #     # #     #
# ##### # ##### # # # ### ### # ### # ### # # #####
#       #     # #   #   # #   # #   # #   # #     #
############# ##### ##### ##### ##### # ### # ### #
#             #   #     # #     #     #     #   # #
### ######### # # ##### # # ### # ############### #
#     #   #   # #   #     #   # #         # #     #
# ##### ### # # ### # ####### # ######### # # # ###
# #       # #     # #     # # #         # # # #   #
# # ##### # ####### ##### # # ### ####### # # #####
# #   #   # #   #   #     # #   # #       # #     #
##### # ### # ### ### ##### # ### # ####### ##### #
#     # #     #   # #   #   #   #   #     # # #   #
# ##### # ##### # # ### # ##### ### # ##### # # # #
#   #   #   #   # #   #   #   # # #             # #
### # ##### # ### ### # ### ### # # ### ######### #
#   #     # #   #     # #   #   # # #   # #     # #
######### ##### ####### # ### ### ### ### # ### # #
#   #       # #   #   #   # #   #   # #   # #   # #
# # ####### # ### # # ### # # # ### # # ### # #####
# #         #     # #   # #   #     # #     #     #
# ############# ### ##### # ######### ########### #
#       # #     #   #     # #   #   #       #     #
####### # # ### # ### ##### ### # # # ### ### #####
#       # # # # #     #     #     # #   #     #   #
# ### ### # # # ####### ##### ### # ### ####### # #
# #   #   # # #         #   # #   #   #     #   # #
### ### ### # ######### # # # # ##### ##### # ### #
#       #   # #   #   # # #   # #   #     # # #   #
# ######### # # # # # # # # ### # # ##### ### #####
# #   #     # # # # # #   # # #   # #   #   # #   #
# # # # ##### # # # # ### # # ##### # # ### # # # #
#   # #     #   #   # #   #   #   #   # #   #   # #
##### ##### ######### ##### ### ####### ######### #
#     #     #       # #     # #   #     #       # #
# ### ### ##### ### # # ##### ### # ##### ### # # #
# #   #   #   #   # # #       # # #     #   # #   #
# # ### ### # ### # # ####### # # ### # # # ##### #
# #     # # # #   #   #           #   #   # #   # #
# ### ### # # # ####### ##################### # # #
# # #     # # # #       #         #           # # #
# # # ##### # # # ######### ##### # ########### # #
#   #       #   #           #     #           #   G
###################################################
