###################################################
S   #     #           #     # #   #   #       #   #
### # ### # ##### ##### ### # # # ### # # ### # # #
# # #   #     #   #   #   # #   # #   # #   #   # #
# # ######### # ### # ### # ##### # ### ### ##### #
#         #   #     #     #     # #     # #     # #
# ####### # # ##### ####### ### # ####### ### ### #
#       #   #   #   #   #   #   #   #     # # #   #
####### # ##### # ### # ### # # ### # ##### # # # #
# #     #   # # # #   #   # # # #           # # # #
# # ####### # # # # ##### # # # # ####### # # # ###
# #     #   # # # #     # # # # # #       #   #   #
# ##### # ### # ####### ### # # # # ######### # # #
#   #   # #   #   #   # #   # #   # #       # # # #
# ### ### # ### # # # # # ### ##### ####### # # # #
#   # #   #   # # # # #   #   #   #     #   # # # #
# # # # ##### ### # # ##### ### # ### # # ### # # #
# #   # #   #   #   #     #     # #   # #   # # # #
##### # ### ### ##### ########### # ####### # # ###
#   # #       #   #       # #     #         # #   #
# ### # # ### ### ##### # # # ########### ####### #
#     # # #           # # # # #         #   #     #
####### # ########### # # # # ### ####### # # #####
#   #   # #         # # # #   #   # #     # # #   #
# ### ##### ####### # ### ##### ### # ### # ### # #
#     #           # #   #   #       #   # # #   # #
####### ######### ##### ### # ##### # # ### # #####
#     # #       # #     # # # #     # #   #   #   #
# ##### # ### # # # ##### # # # ##### # # ##### # #
# #   # # # # # # # # #     # # # #   # #       # #
# # # # # # # # # # # # ### # # # # ### # ####### #
# # # #   # # # #   # #   # # # #   #   #   #   # #
# # ####### # ####### ### # ### ####### ##### ### #
# #       #   #     #     #     #   #   #   #     #
# ####### ##### ### ### ######### # # ### # # #####
#     # #   #     # #     #       # # # # # # #   #
# # # # ### # ##### # ##### # ##### # # # ### # # #
# # #   # # #     # #   #   # #     # # # #   # # #
# # ### # # ##### ##### # ### # ### # # # # # ### #
# #   #     #   #     # # #   #   #   # #   #     #
# ### ##### ### ##### # # # ##### ##### # #########
# #   # #   #           # # #   #       #         #
# # ### # ### ##### ####### ### ########### # ### #
# #   # #   # #     #   #   #   #   #     # # #   #
# ### # # # # # ##### # # ### ### # ##### # # #####
#   #   # # # #     # #     #   # # #     # #     #
### ##### # # ##### # ##### # # ### # ########### #
# #     # #   #     #     #   #   # # #     #   # #
# ##### ######################### # # # ### # # # #
#                               #   #   #     #   G
###################################################
