###################################################
S:  #:::#:::::#               # #     #   #     # #
#:###:#:#:###:# ############# # # ### # # # ### # #
#:::::#:::# #:  #         # #   # #     #   #   # #
# ####### # #:### ####### # ### # ####### ### ### #
#   #   # #  :::# #   #   # #   #     #     #     #
### # # #######:# # # # # # ##### ### # ###########
#   # # #   #:::# # #   #   #     #   #       #   #
# ##### # # #:### # ######### ##### ####### # # # #
#       # # #:#   #       #   #   # #     # #   # #
### # ##### #:# ### ##### # ##### ### # # # ##### #
#   #   #   #:::::#     #   #   #     # #   # #   #
# # ### # ### ###:##### ##### # ### # # ##### # ###
# #   # #   # #:::#   #   #   #     # #     #   # #
# ##### ### ###:##### ### # ############### # # # #
# #   #   #  :::#         # #     #   #   # # # # #
# # # #######:### ######### # ### ### # # # ### # #
# # # #     #:::# #         #   #     # # # #   # #
# # # # #######:# # ####### # ####### # # # # ### #
# # # #      :::# #   #   #         #   # # #   # #
### # #######:### ### # # ######### ##### # ### # #
#   # #      :# # #   # # #   #   #   #   # # # # #
# ##### #####:# # ##### # ### # # ### # ### # # # #
# #     #:::::# #       # #   # # #   # # # # # # #
# # ### #:##### ######### # ### # ##### # # # # # #
#   #   #:#:::  #     #   # #   #     #   #   # # #
####### #:#:#:### ### # ### # ##### # ####### ### #
#       #:::#:#   #   #   #   #     # #     #     #
# ###########:# ##### ### ##### ##### ##### ### # #
# # #    :::::#   #   #     #   #   # #     # # # #
# # # ###:####### # ####### # ##### # # ##### # # #
# #   #  :::::::# #   #   #         #   #     # # #
# #############:# ### # # ############### ##### # #
#     #     #:::#   #   #       # #     #   #   # #
### ### # # #:##### ######### # # # ####### # ### #
#     # # # #:#:::#:::#     # # #   #     #   #   #
# ### # # # #:#:#:#:#:# ### ### # # # ### ##### ###
# #   # # # #:::#:::#:#   # #   # # # #       # # #
# # ##### ######### #:### # # ##### # # ### ### # #
# # #   # #   # #   #:#   # #     # # #   #   #   #
# # ### # # # # # # #:# ######### # ##### ### # ###
# #   # #   #   # # #:# # #:::::# #       #   #   #
# ### # ####### # ###:# # #:###:# ########### #####
#   # #       # # #:::  #:::# #:#             #:::#
### # ####### # # #:#####:### #:######### #####:#:#
#   #       # #   #:#:::::#   #:::::#   # #:::::#:#
# ######### # #####:#:####### # ###:### # #:#####:#
#   #       #   #:::#:    #   #   #:::#   #:::#:::#
### # ##### ### #:###:### # #########:#######:#:###
#   #     #     #:::::#   #          :::::::::#:::G
###################################################
