###################################################
S   #         #       #         #                 #
# # # ####### # ### # # ####### # ### ##### #######
# #   #     #   #   # # #       #   #     # #     #
####### ### # ##### # # # # ####### ##### # # ### #
#   #   #   # #     #   # # #     # #   # # # # # #
# # # ##### # # ### ####### ### # ### # # # # # # #
# #   #   #   # # #       #   # #   # #   #   #   #
# ####### # ### # ####### ### ##### # ####### #####
# #       #   #     #   # # #   # #   #   #   #   #
# ### ### # ####### # ### # ### # ### # ### ### # #
#     #   #   #   #   #   #     #     #     #   # #
# # # # ##### # # ##### ######### # ######### ### #
# # # #   #   # #     # #   #   # #     #   # #   #
# ### ### # ### ##### # # # # # # ####### ### # ###
#   # # # # #   #   # #   #   #   #       #   #   #
### # # # # ##### # # ##### # ##### ####### ##### #
#   # # # #   #   # #     # # #   # #       #   # #
# ### # # ### # ### # ### # # ### # # ####### # # #
#   # #   #   #   # # #   # #     #   #       #   #
### # ### # ##### # ### ############### ####### ###
# # # #   #   #   #   # # #       #   #       #   #
# # # # ##### # ##### # # # ##### ### ##### # ### #
#   # #     #       # #   #   #   #   # #   #   # #
########### ##### # # ### ### # ### ### # ##### # #
#     # #   #     # #     #   #   # #     #   # # #
# ### # # ######### ### ### ##### # # ##### # ### #
#   # # #       #   #   # #     #   #   #   #     #
# ### # ####### # ### ### ##### ####### # ### #####
# #   #         # #   #     #   #       #   # #   #
# # ############# # ### ### # # # ######### # # ###
# #   #       #   #       #   # # #         # #   #
# ### # ##### # ############### # # ######### ### #
# # # #     #   #     #   #   #   # #     # # # # #
# # # ##### ##### ### # # # ### ### # ### # # # # #
# # # # #   #     #   # # #     #   # #   #   #   #
# # # # # ### # ### ### # ######### # # ######### #
#   #   #   # # # #     # #       # # #   #       #
####### ##### # # ####### ### # # # ### ### #######
#   #   #     #   #     # #   # # #   #   #       #
# # # ### # # ##### ##### # ##### ### ### # ##### #
# # #   # # #   # # #     #   #   # #   # #     # #
### ### # # ### # # # ##### # # ### ### # ##### ###
#   #     #   # #   # # #   # #   #     #     #   #
# ### ####### # # ### # # # # ### ##### ##### ### #
# # #   #     # #     # # # # # #       #     #   #
# # ##### ##### ##### # # # # # # # # ### ##### # #
# #     #     #     #   # # #   # # #       #   # #
# # # # ##### ##### # ### # ##### ########### ### #
#   # #       #     #     #     #             #   G
###################################################
