###################################################
S:::::#    :::::::    #:::::::::#     #   # #   # #
#####:#####:### #:### #:##### #:# ### ### # # # # #
#   #:::#:::#   #:::# #:#     #:#   #   # #   # # #
# # ###:#:#########:# #:# #####:####### # # ### # #
# #   #:::#       #:# #:# #   #:#:::#   # #   #   #
# ######### # ### #:###:# # # #:#:#:# ### ##### ###
#       # # # # # #:::::#   # #:::#:::::::::::#   #
####### # # # # # ####### ### ############# #:### #
#       #   #   # #       #   #     #       #:::  #
# ### ########### # ########### ### ##### ### #:###
# #   #         # #       #     #   #     #   #:# #
### ### ####### # ### ##### ##### # # # ### ###:# #
#   #   #   #   #   #   #   # #   #   #   # # #:# #
# ### ### ### ##### ##### ### # ######### # # #:# #
# #     #   #   #       # #   #   #   #   #   #:::#
# # ####### ### # ##### # ### ### ### # #########:#
# # # #     # # # #   #   #   #     # # #        :#
# # # # # # # # # # ### # # ### ### # # #########:#
# #     # # # # # #     # #       #   # #   #:::::#
# ######### # # ######### ####### ##### # # #:#####
#         #   #         #     # #   # # # # #:#:::#
######### ### ####### # ##### # ### # # # ###:#:#:#
#       # #   #     # #       #     # # #   #:::#:#
##### # # # ### ### ##### ########### # ### ### #:#
#     #   #   # # #   # #   #       #   # #     #:#
# ########### # # ### # ### # ### ####### # #####:#
# #       #   #   #   #   # # #   #   # # # #:::#:#
# # ### # # # ##### ##### # # # ### # # # ###:#:#:#
#   #   # # #   #       #   # #   # #   #   #:#:::#
# ####### # # # # ######### # ### # ### ### #:#####
# #       # # # # #   #   #   #   #   #   #  :#   #
# # ####### # # # ### # # ##### ######### # #:# # #
# #   #   # # #   #   # #     #         #   #:  # #
# ### # # # # ##### ### ##### # ##### #######:### #
#   #   # # # #   #     #   # # #     #   #  :# # #
# # ##### ### # # ##### # # # ### # ### # ###:# # #
# #   #   #   # #   #   # # # #   #     # #:::# # #
# ### # ### ### ### # ### # # # # ####### #:### # #
#   # #       #   #   #   #   # #   #     #:#   # #
##### ### ### ### ##### ####### ### # #####:### ###
#       #   # # #   #   #   #     # #   # #:  #   #
# ##### ##### # ### # ### # # ### # ### # #:# ### #
#   #   #   #   #   # #   #   # # #   # # #:#     #
### # ### # ##### ### # # # ### # ### # # #:#######
#   #     #     #   #   # #   #   #   #   #:#:::# #
# ######### ####### ##### ######### #######:#:#:# #
# # #     # #     # #   #         # #   #:::#:#:# #
# # # ##### # ### # # ########### # # # #:###:#:# #
#   #       #   #   #             #   # #:::::#:::G
###################################################
