###################################################
S:::::::::#         #   #       #   #     #       #
##### ###:# ####### # ### # ##### # # ### # ##### #
#       #:::::  #     #   # #   # # # # # #   # # #
####### #####:### ##### ### # # # # # # # ### # # #
#     #   #:::  #     #   #   #   # # #   #   # # #
# ####### #:### ##### ##### ######### ##### # # # #
#   #     #:::# #     #     # #     #     # # #   #
### # #######:# # ##### ##### # ### ##### # #######
#   # #     #:# #   #   # #     #         #   #   #
# ### ##### #:### # # ### # ################# # # #
#           #:::# #   #   # #   #     #     #   # #
###############:# ##### # # # # # ##### ### ### ###
#:::# #   #:::::#   # # #   # # # #       #   #   #
#:#:# # ###:# ##### # # ####### # # ##### ### ### #
#:#:::::::::# #     #     #     #   #   # #     # #
#:####### ### # ##### ### # ##### ##### ### ##### #
#:::::# # #   #       # #   #     # #     #       #
# ###:# # # ########### # # # ##### # ### ####### #
#   #:#   #   #:::::::# # # #   #   #   #         #
#####:#########:#####:# # # # # # ##### ###########
#   #:::::  #:::#:::::# # #   # # #   # #     #   #
# # ### #:###:###:##### # ####### # ### # ### ### #
# #     #:  #:#  :#:::#   #   #   # #   #   #     #
# ##### #:# #:# #:#:#:##### # # ### # # ### #######
# #     #:# #:# #:#:#:#   # # # #   # #     # #   #
# # #####:###:# #:#:#:# ### # # # ### ####### # ###
# #     #:::::# #:::#:#     # # #     #       #   #
# ##### ### ### #####:####### # ####### # ### # # #
#     # # #   #   # #:#       # #   # # # # #   # #
##### # # ### ### # #:# ####### # # # # # # ##### #
#     #   # #   # # #:#       # # # # # #   #   # #
# ##### ### # # # # #:# ##### # ### # # ####### # #
# #     # # # # # # #:::::::# # #     #         # #
# # ##### # # # # # #######:# # # ### ########### #
# # #     # # # # #       #:#   # #   #         # #
# # # ### # # # # ### ### #:### # # ########### # #
# # #   # # # # # # # #   #:::#   #   #         # #
# ##### # # ### # # # # #####:####### # ### ### # #
#   #   #   #   #   # # #   #:::::#   # # # # # # #
### # ####### ##### ### # # #####:# ### # # # # # #
# # # #     #     #   #   #     #:#     #   # # # #
# # # # ### ### ##### ######### #:##### ##### # # #
#   # #   #     #   # #   # #   #:::  #   # # #   #
# ### ### ####### # # ### # # # ###:##### # # ### #
# #   # #   #     # #   #   # #   #:::::#   #   # #
# # ### # ### ##### ### # # # #########:####### # #
# #     # #   #   #   #   #   #     #  :::#:::#   #
# ##### # # ##### ### ##### ### ##### ###:#:#:#####
#     #   #         #         #         #:::#:::::G
###################################################
