###################################################
S #     #   #     # #             #               #
# ##### # ### ### # # # ######### # ######### ### #
#       #       # #   #     #   # # #   #     #   #
### ########### # ### ####### # # ### # # ### # ###
#         #   # #     #       # #     # # #   #   #
# ####### # ### ####### ############### # # ##### #
#       # # #   #       #   #     #   #   # #   # #
### ##### # # ### ####### # # ##### # ### # # # # #
# #     #   #   #   #     # #       #   # #   # # #
# ##### # ##### # # # ##### ########### # ##### # #
#       #     #   #   #     #         # # #     # #
### ####### # # ### ### ### # ####### # # # ##### #
#   #   # # # #   # # #   #   #   #   # # # #   # #
# ##### # # # ##### # ### ##### # ##### # # ### # #
# #   #   # # #   #   #       # #   # # # #     # #
# # # ### # # # # ##### ####### ### # # ###########
# # #   # # #   #   #   #     #   #   #     #     #
# # # # # ######### # ### ### ### ### # ##### ### #
#   # # # #   #         # # #   #   #       #   # #
##### # # # # # ####### # # ### ### ####### ### # #
# #   # # # # # # #     #   # #   # #   #   #   # #
# # ##### # # # # # # ### # # ##### # # # # # ### #
#   #   #   # # #   #   # #       # # #   # #   # #
### ### ##### # ### ### # ####### # # ##### ##### #
#   #         # #   #   #   #   # # # #   #   #   #
# ### ######### # ##### ### # # # ### # ##### # ###
#   # #     #   #     #       # #     #       #   #
# # # ##### # ####### ####### ################### #
# # # #     # # #     #     #               #   # #
### # # ##### # # ##### ### ####### ####### # # # #
#   # #   #   #   # #     #     #         # # # # #
# ### ### # ####### # ### ##### # ####### # # ### #
#     # #   #         #     #   # #   #   # #   # #
# # ### ##### ############# ##### ### ##### ### # #
# #     # #     #   #   # #         #   #       # #
# ### ### # ### # # # # # # ####### ### # ####### #
#   #   # #   #   # # #   # #   #     # #   #     #
####### # ### # ### # ##### # ### ### # ### # #####
#       #     #   #   # #   # #   #   # #   #   # #
# ##################### # ### # ### ### # ##### # #
#     #   #     #     # # # # #   # # # #     #   #
##### # # ##### # ### # # # # ### # # # # ### ### #
#   #   #       # #   # #   #   # #     #   #     #
# # ######### ### # ### ####### # # ####### #######
# # #     # #   # #     #     #   #       #     # #
# # # ### # ### # ####### ### # ############### # #
# # # #   #     # #     # #   #     #       #   # #
# ### # ##### ### # # # # # ### ### # ##### # ### #
#     #         #   # #   #       #   #     #     G
###################################################
