###################################################
S         #     #             #   #   #     #     #
######### ##### # ####### ##### # # ### ### ##### #
#   #   #       # #     #       # #     #         #
# ### # ##### ##### # ### ##### # # ############# #
#     #       # #   #       #   #   #           # #
####### # ### # # ##### ### ######### ######### ###
#     # #   # #   # #   #       #     #     # #   #
# ##### ### # ### # # ### ##### # ##### ### # ### #
# #     #   #     # # #       # #         # #   # #
# ### ### ### ##### # # ##### # ######### # ### # #
#     #   #     #   # # #   # #         # #   # # #
### # # ### ### # ### # ### ########### # ### # # #
#   # # #     # #   # #     #   #   # #   #   #   #
# ### ### ##### ### # ####### # ### # ########### #
#   #   # #   #   #   #       #     #   #     #   #
####### # ### # ### ########### ####### # ### # ###
#   #   #   # #   # #   #   # #       # #   # # # #
# # # ##### # ### # ### # # # # ####### ##### # # #
# # #   #     # # #     # #   #   #     #     #   #
# ##### # ##### # ##### # ### # # # ##### ##### # #
# #     # #     #     # # # #   # #       #   # # #
# # ### # # ####### # # # # # ##### ### ##### ### #
#   #   # #         # # # # #     # #       #   # #
####### ############### # # ### # # # ##### ### # #
#       #               #   #   # # #   # #   # # #
# ####### # ################### # # ### # # ### # #
# #     # #       #   #         #   # # #     # # #
# ##### # ####### # # # # ########### # # ### # # #
#     # #   # #   # # # # #   #       # #   # #   #
##### # ### # # ### # # # ### # ####### ### #######
# #   # #   #   # # #   #     # #   #     #     # #
# # ### # ####### # ########### ### # ### ##### # #
# #     #   #   # #     #     #   #     #     # # #
# ### # # ### # # # # # # ### ### ##### ### # # # #
# #   # # #   #   # # # # # # #     #   #   # #   #
# # ### # # ### ##### # # # # ##### # # ######### #
# # # # #   #   # #   # # #   #     # #         # #
# # # # ##### ### # ### # ### # ########### ### # #
# # #   #           # #   #   # #           #   # #
# # ##### ######### # ##### ### ### ######### # # #
# # #   # #       # #     #   #     #         # # #
# # # ### # ##### # ##### # ### ##### ########### #
# # #     # #   #         #   #   #   #           #
# # ####### # # ############# ##### ### ###########
#   #     # # # # #   #     # #     #   #   #     #
##### # # # ### # # # # ### ### ######### # # ### #
#   # # #   #   #   # # # #   #           # #   # #
# # # ####### ####### # # ### ####### ##### ### # #
# #                   #     #             #     # G
###################################################
