###################################################
S:::  #         #   #     #         #   #     #   #
# #:# ######### # # # ### # ####### # # ### # # # #
# #:#       #   # # # #   #   #   # # #     # # # #
###:##### ### ### ### # ##### # ### ##### ### # # #
#:::#     #   #       #   #   #   #   # # # #   # #
#:######### ####### ##### # ##### ### # # # ##### #
#:::::#     #       # #   # #   #       # #       #
#####:# ##### # ##### # ### # ##### ### # ##### ###
#:::::# #   # #   #     # # #     # #   #   #     #
#:# # # # # ### # ##### # # # ### # ### ### # #####
#:# # # # #     # #   # #   #   # #   #     # #   #
#:# # # # ####### # # ####### ### ### ####### ### #
#:# # #   #       # #   #     #   # #       #     #
#:### ##### ####### ### ### ### ### # ##### #######
#:::# #   # #       #         #     # #     # #   #
###:# # # # # ######################### ##### # # #
# #:# # # # #   #       # #     #         # # # # #
# #:### ### # # # ##### # # ### # ####### # # # # #
#  :::::#:::::# # #     # # #   # #     #     # # #
# #####:#:###:# # # ##### # ##### # ### ####### ###
#     #:::#  :#   #   #   # #     #   # #     #   #
#############:####### # # # # ######### # ### ### #
#   #     #:::# #     # # #             # #     # #
# # # # ###:### # # ##### # ######### ##### ### # #
# #   #   #:#:::# #       # #   #   #     #   # # #
# ### ### #:#:#:### ##### # # # ### ##### ### # # #
# #   #   #:#:#:::#     # # # #   # #     #   # # #
# # ### ###:#:###:####### # # ### # # ##### ### # #
# # #     #:::#  :::::::#     # # #         #     #
### # ### ##### #######:####### # #################
#   # #   #   #     # #:#       #   #:::#:::::::::#
# ##### # # ####### # #:# ##### ### #:#:#:#######:#
# #   # # #           #:#   #   #   #:#:::#   # #:#
# # # ### #############:### # #######:##### # # #:#
#   #   # #     #:::#:::#   # #:::#:::#   # # # #:#
####### # ##### #:#:#:####### #:#:#:# # # # # # #:#
#   #   #     #  :#:::#       #:#:#:# # # # #   #:#
# # # ####### ###:##### #######:#:#:# # # # # ###:#
# # # # #     #:::      #:::::::#:#:# # # # #   #:#
# ### # # #####:#########:#######:#:### ### ### #:#
#     # #   # #:#:::#   #:#   #:::#:::#   # #   #:#
##### # ### # #:#:#:# ###:# # #:#####:# # # # ###:#
#   # #   # # #:::#:#:::::# #  :::::::# #   # #:::#
# # # ### # # # ###:#:##### # ######### ##### #:###
# # #   # # # # #:::#:#   # # #           #   #:# #
# ##### # # # ###:###:### # ### ########### ###:# #
#       #     #:::#:::#   #           #   # #:::# #
####### #######:###:# # ############# # # # #:### #
#              :::::# #               # #   #:::::G
###################################################
