###################################################
S   #     #   #     #     #                   #   #
### # # # ### # ### # ### # ######### ### ##### # #
# #   # # #   #   #   #   # # #       #   #     # #
# # ### # # ##### ### ##### # # # ##### ### ##### #
# # #   # #       # #   #     # # #   #   #   #   #
# # ### ### ####### ### # ##### # # ##### ##### ###
# # #       # #   #     # #     # # #   # #       #
# # # ##### # # # ######### ####### # # # # ##### #
#   # #   # #   #     #           # # #   # # #   #
##### ### # ### ##### # ##### ### # # ##### # # ###
#   # #   #   #     # # #   #   # # #       # # # #
# ### # ##### ##### # # ### ### # # ######### # # #
#     #             # # #   #   # #         # # # #
# ##### ########### # # # # ######### ### # # # # #
# #   # #         # # # # # #         #   #   #   #
# # # # ######### ### # ### # ### ##### ######### #
# # # #       # #     # #   # #   #   # # #     # #
### ##### ### # ##### # # ### # ### # # # # ##### #
#         # # #   #   #       # #   # #   # #   # #
# ### ##### # ### # ########### # ### # ### # # # #
#   #     #   #   #     #   #   #   # #   #   #   #
##### ######### ### # # # # # ##### # # # # #######
#   # #     #   #   # #   #   #     #   # # #     #
# # # # ### # ### ####### ####### ### ### # # #####
# # #   #   #   #   #   # # #   #   # # # # #     #
# ### ### ##### # ### # # # # # ### # # # # # ### #
# #   # #     #   #   #   #   # #   # #   #   #   #
# # ### # ######### ####### ### ##### ######### # #
# #     #   #       #     #   #       #         # #
# # ####### # ### ### ### # # ######### ######### #
# # #       #   # #   # #   # #   #   # #     #   #
# # # ### ##### ### ### ##### # # # # # ##### # ###
#   #   #     #   #     #     # # # # #     # #   #
# ##### ######### ####### ##### # # # ##### # ### #
#     #   #     #       #       #   # #   # #     #
######### # ### ### ### ############### # # #######
# #   # # # # #     #   #         #   # #     #   #
# # # # # # # ########### # # ##### # # ####### # #
# # # # # # #     #       # #     # # #   #     # #
# # # # # # # ### # ############# # # # # ####### #
#   # #   # # #   # # #     #   #   # # #     #   #
### # ### # # # # # # # ### # ### ### # ### ### ###
#   #     #   # #   # # #   #     #   # # # #   # #
# ############# # ### # # ############# # # # ### #
#           #   # #   # # # #         #   #   #   #
####### ### # ##### ### # # # ####### ### ##### ###
#     #   # # #         # # #       # #       #   #
# ### ##### # ########### # ####### # # ######### #
#   #       #           #           #             G
###################################################
