###################################################
S:::::::::::::::#             #   #       #   #   #
##### #########:####### ####### # # ##### # # # ###
#     #   #   #:::# #     #     #   #     # #     #
# ##### # ### ###:# # ### # ### # ### # ### ##### #
#     # #   #   #:  #   # # #   # #   #   # #   # #
# ### ##### # # #:##### # # ####### ##### # # ### #
#   #     #   # #:::#   #   #     # #   # #   #   #
### ##### ##### # #:######### ### # # # ####### ###
# #     #       # #:::::# #   #     # #   #       #
# ### # ######### #####:# # ### ##### ### # ##### #
#     # #     #   #   #:# # # #       # #   # #   #
# ##### # ##### ### # #:# # # ######### ##### # ###
#   #   #     #     # #:::::#    :::  #     #     #
### # ####### # ###########:#####:#:####### ##### #
#   #   #     #           #:::::#:#:::::::# #   # #
### # # # # ######### ### ### #:#:#######:# # ### #
#   # # # #   # #   #   #   # #:#:::::# #:# #     #
# ### ### # # # # ##### ### # #:#####:# #:# # #####
# #   #   # #   #       #   # #:::::::  #:#   #   #
# # ### ### ############# ### # #########:##### # #
# # # #   #   #           #   #   #:::  #:#     # #
# # # ####### # ########### #######:#:# #:# #######
# # #   #   #   #         #     #:::#:# #:#   #   #
# # # # # # ##### # ##### # ### #:###:###:# # # # #
# #   #   #   #   #   #     #   #:::#:::::# #   # #
# # ######### ##### # ########### #:######### ### #
# # #   #     #   # #     # #   # #:::#:::#   #   #
# ### ### ##### # ####### # # # #####:#:#:# ### # #
# #             # #         # #     #:::#:::#   # #
# # ############### ######### ##### #######:# #####
# #           # #   #     #   # #       #:::# #   #
# ########### # # ####### # ### # ##### #:### ### #
#   #   #   # #         #   #   # #     #:::#     #
# # # # # # # ##### ### ### # ### #########:#######
# #   # # # #   # # # #   #     # #     # #:#:::# #
# ##### # ##### # # # ### ##### # # # # # #:#:#:# #
#     # #       #   #     #   # #   # #   #:::#:::#
####### ############# ##### ### # ### ### #######:#
#     # #       #   #           # #   #         #:#
# ### # # # ### ### ### ########### ### ####### #:#
# #   #   # # #   # # #     #     # # # # #   # #:#
# ######### # ### # # ### # # ### # # # # # # # #:#
# #         #   #   #   # #   #   #   # #   # # #:#
# # ####### ### ####### # ##### ####### ##### # #:#
# #   #   #   #   #   # #     #   #   #   #   # #:#
# ### # # ### ### # # # ######### # # # ### #####:#
# # # # #   #   #   # #   #   #   # # # #   #    :#
# # # ##### ### # ### ### # # ### # ### # ### ###:#
#             #     #   #   #     #       #   #  :G
###################################################
