###################################################
S:# #:::::::#     #:::#:::::::::    #   #     #   #
#:# #:#####:# #####:#:#:#######:### ### ### # ### #
#:::::#   #:::::::::#:#:#:::::#:::#     #   # #   #
# ####### # #########:#:#:###:###:####### ##### # #
#   #   #     #     #:#:::#:::#  :::  #   # #   # #
### ### ##### # ### #:#####:#######:# # # # # ### #
# #     #   # #   # #:#    :# #:::::#   # #   # # #
# # ##### # # # # ###:#####:# #:####### ####### # #
# # #   # # #   #   #:::::#:# #:::#:::#         # #
# # # # # # ####### #####:#:# ###:#:#:########### #
# # # # # #       # #   #:::# # #:::#:#           #
# ### # # ######### # # ##### # # ###:# # #########
#   # # #   #       # #     # # #   #:# # #       #
# # ### ### # ########### # # # ### #:### # ##### #
# #     #   # #         # #   #     #:#   #   #   #
# ### ### ### # ##### ### ##### #####:# # ##### ###
#   # #   #     #   #     #   # # #:::# #       # #
### # # ######### ##### ### # # # #:### ######### #
#   # #             #       # # # #:::#         # #
# ### # ########### # ####### # # # #:####### # # #
#   # #       #   #   #     # #   # #:::#     # # #
### # ####### ### ### # ##### #########:# ##### # #
# # #   #       #     #       #  :::::#:# #   #   #
# # ### # ##### #################:###:#:# ### #####
#   # #   # #   #         #   #:::#  :::#     #   #
### # ### # # ### ####### ### #:####### ##### # # #
# # #   # #     # # #   #   # #:::::::#   #   # # #
# # ### # ##### # # # # ### # # #####:### # # # # #
#     # # #   #   #   #     # # # #:::  #   #   # #
##### # # ### ############### # # #:### ###########
#   # # #   #   #   #       #   # #:::# #   #     #
# # # # ### ### # # # ##### ##### ###:# # ### ### #
# # # # #   #   # #   #   #        :::#       #   #
# # # # # ### # ##### ### #########:########### ###
# #     # #   #     #   #   #   # #:::::::#:::# # #
######### # ### ### # # ### # # # #######:#:#:# # #
#     #   #   # # # # #   #   # #       #:::#:# # #
# ##### # ##### # # ### # ##### # ##### #####:# # #
#     # # #     # # #   #       #     #   # #:#   #
##### # # # ##### # # ############### ### # #:#####
#   # # # #       # #       #         #     #:#   #
# # # # # ####### # ####### # ######### #####:# ###
# # #   # #       # # #     #         # #   #:#   #
# ####### # # ##### # # ############# # # # #:### #
#       #   #     #   # #   #       # #   # #:#:::#
# ##### ### ##### ##### ### # ##### ### ### #:#:#:#
#     #   # #   # #   #     #   # #   #   # #:#:#:#
##### ### ### # ### # ##### ### # # # ### # #:#:#:#
#       #     #     #             # #     # #:::#:G
###################################################
