###################################################
S #     #       #     #   #                 #     #
# ### ### ##### ##### # # ### ##### ######### ### #
#     #       # #     # # #       #         # #   #
# # ### ##### # # # ##### # ### # ######### # # # #
# # #   #   # # # #     #   # # #       # #   # # #
# # # ### # ### ####### # ### # ####### # ##### # #
# # # #   # #   #     # #     #   #     #     # # #
# # # ##### # ### ### # # ####### # ######### # ###
# # #     # #   #   # #   #       # #   #     #   #
# ####### # ### ##### ####### ### ### # # ####### #
#       #     #     #           #     # #   #   # #
### ### ##### ##### ####### ########### ### # # # #
# #   #     #     # #   #   # #     #     # # #   #
# ### ##### ####### # # ### # # ### ##### # # #####
# #   #   #   #       #       # # #     # #   #   #
# # # # ### # # ####### ####### # ##### # ##### # #
# # # #   # #   #       #     # # # #   # #   # # #
# # # # # # # ######### ##### # # # # ### # # # # #
#   # # #   #     #   # #     #   # # # # # #   # #
####### ######### # # ### # ### ### # # # # #######
#   #   #       # # #     # #   #   # # # #       #
# ### ### # # ### # ####### ####### # # # ####### #
# #   #   # #           #   #     # # # # #   #   #
# # ### ############### # ### ### # # # # # # # ###
# # #         #   #     # # #   #   # #   # # #   #
# # ####### # ### ####### # ### ##### ### # ##### #
# #   #     #   #       # # #   #     # # #       #
# ### # ####### ####### # # # ### ### # # ##### ###
# #   # #       #   #   #   # # # #   # #   #     #
# # ### # ######### # # ##### # # # # # ### ##### #
#   #   #             #   #   #   # # #   # #     #
##### ######### ########### ####### # # # # # # ###
#   #     #     #           #     # # # # #   # # #
# # ##### # ##### ##### ##### ### # # # # ##### # #
# # #     # #     #   # #   #   #   # # #     # # #
# # # ### # # ##### # # # ####### ### ####### # # #
# #   #   #   #   # # # # #       # #     #   #   #
# ##### ### ### # # # # # # ####### ##### # ##### #
# #     #   #   #   # #     #     #     # #   #   #
# ####### ### ################### ##### # ### # ###
#       #     #   #     #         # #   #   # #   #
##### ######### # # # # # ######### # ### # # ### #
#     #       # # # # #   #         # #   # #   # #
# ##### # ### # # ### # ##### ##### # ##### # ### #
# #     #   #   #     # #     #     #     # #     #
# ####### ### ######### # ##### ### ##### # #######
#   #       # #   #     # #   #   #     # #   #   #
# # # ##### # # ### ####### # ######### # # # # # #
# #   #     # #             #             # #   # G
###################################################
