###################################################
S:::#     #       #     #       #     #   #     # #
# #:# ### # # ##### # # # ##### # ### # ### ### # #
# #:#   #   #:::    # # # #   #   # #   #   #     #
# #:#########:#:##### ### ### # ### ##### ### #####
# #:::#:::::::#:#   #     #     # #     # #   #   #
# ###:#:#######:# # ####### ##### # ### # # ##### #
#   #:::#:::::::# # #   #   #:::::# # #   # #     #
# # #####:######### # # # ###:###:# # ##### # #####
# #   # #:#:::::::# # # # # #:# #:# #   # #   #   #
# ### # #:#:#####:# # ### # #:# #:# ### # ####### #
#   #   #:#:::::#:# #     #:::# #:#   #       #   #
####### #:#####:#:# #######:### #:### # ##### # ###
#     # #:::::::#:#:::::::::#   #:#   # #   # #   #
# ##### # # #####:#:######### ###:# ### ### # ### #
# #     # #   #:::#:  #     # #:::  #   #   #     #
# # ######### #:###:# # ### # #:####### # ### ### #
#   #       # #:::::#   # #   #:  # #   #   #   # #
### ####### # ########### # ###:# # # ##### ##### #
#   #     # # #   #   #   #   #:#   # #   #       #
# ### # ### # # # # # # #######:##### # ###########
#     #   #   # # # #   # #    :::::# # #         #
####### # ##### # # # ### # # ### #:# # # #########
#       #       #   # #   # #   # #:::::#     #   #
# ##### ############# # # ##### #######:##### # # #
# #   #     #   #   #   #     # #     #:::::#   # #
# ### ####### # # ######### ### # # # #####:##### #
#     # #     #   #   #   # #   # # #  :::::      #
##### # # ####### # # # # # # ### #####:######### #
#   # #   #   #   # # # #   #   #     #:::#  :::# #
# # ##### ### # ### # ###################:# #:#:###
# #           #   # #     #     #   #    :# #:#:::#
# ############# # # ##### # ### # # # # #:###:# #:#
#   #   #     # # #     # # # #   #   # #:::::# #:#
# ### ### ### # # ##### # # # ### ### # ####### #:#
#   # #   # #   #   # # # #     # #   # #   #   #:#
### # # ### ##### # # # # ##### ### ### # # #####:#
#     # #   #     # # # #   #   #   #   # #   #  :#
# ##### # ### ##### # # ### # ### ### ##### # ###:#
# #     #     #     #     # # #   # #   #   #   #:#
# ############# ######### # # # ### # # # ##### #:#
#   #   #           #   # # # #   #   #   #   # #:#
### # # ### ######### # # # # ##### ####### # # #:#
# # # # #   #   #     #   #   #     #       # # #:#
# # ### # # # # # ############# ##### # ##### ###:#
# # #   # #   # #     #     #         #     # #:::#
# # # ######### ##### # ### # ######### ##### #:###
# # # #   #   #       #   #       #     #   # #:# #
# # # # # # # ########### ######### ##### # ###:# #
#   #   #   #             #         #     #    :::G
###################################################
