###################################################
S   #       # #   #       #   #       # #     #   #
### # ##### # # # # # ### ### # ##### # # ### # ###
# #   #     # # #   # # #     # #     # # # # #   #
# ##### ### # # ##### # ####### # ##### # # # ### #
#       #   #   #   # # #       #     # #   #   # #
### ##### ### ##### # # ####### ##### # # ### # # #
# #     #     #     #   #     # #     # # #   # # #
# ##### ##### # ##### ### ### # ####### # ##### # #
# #   # # #   #       #   #   #     #   #     #   #
# # # # # # ####### ### ### ####### # ####### # ###
# # #   #       #   # # # #         # #   #   # # #
# # ########### # ### # # ##### # ### # # ##### # #
# #     # #     #     # #       #     # #     #   #
# ##### # # ########### ############### ### # ### #
#         # #   #       #     #         #   #     #
### ####### # # # ####### ### # ############# # # #
#         #   # # #       # # #     #     #   # # #
####### # ##### # ### ##### # # # # # ### # ### # #
#     # #   #         #   # # # # #   #   #   # # #
# ##### ### # ##### ### ### # ### ##### ####### # #
#   #   #   # #   #     #     #   #   # #     # # #
### # ### # # ### ####### ##### # # # # ### # # ###
#   #   # # #   # #     #   #   #   # #   # # #   #
# ##### # ##### # # ### ### # # ######### ### ### #
#       #   #   # # #     # # # #       #   # # # #
########### ### # ### ### # # # # ##### ### # # # #
#   #   # #   #     # #     # # #     #   #   #   #
# # # # # ### ##### ### ##### # ####### ######### #
# # # # #   #     #   # #   # #     #   #   #   # #
# ### # ### ######### # # ### ##### # ### # # # ###
# #   # #         #   # #     #   #   #   # # #   #
# # ### # ####### # ### ### # # # ##### ##### ### #
#   #   # #   #     # #     # # #     #       #   #
##### ### # # # ##### ####### # ##### ######### # #
#   #     # # # #   # #   #   # #       # #   # # #
# ##### ##### # # ### # # # ### # ##### # # # ### #
# #     #     # #   # # #   #   # #   # #   #     #
# # ##### ####### # # # # ####### # # ### #########
# #   # #       # # #   # #     #   # #     #     #
# ### # ##### # # # ##### # # ### ##### ##### ### #
#   # #   #   #   #   # #   #     #     #     #   #
### # # # # ##### ### # ##### # ### ########### ###
# # #   # # #   #   #       # #   # #       #   # #
# # ##### ### # ### ##### # ##### # # ##### # ### #
# #   #   #   # #   #     #   #   # # #   # #     #
# # # # ### ##### # # ####### # ### # # # # # ### #
#   # # #   #   # # #       #   #     # # #   #   #
# ### # # ### # # # ####### ########### # ##### # #
#   #   #     #   #       #             #       # G
###################################################
