###################################################
S:#  :::#         #       #   #   #       #     # #
#:###:#:# ### ##### # ### # ### # # ##### # ### # #
#:::::#:#   #     # #   # #   # #   #     #   # # #
#######:######### # ### # ### # ##### ####### # # #
#:::# #:#:::::#     # # #   # # #   # # #   # # # #
#:#:# #:#:###:# ##### # ### # # # ### # # # # # # #
#:#:::#:::#:::  #     # #   # # # #   #   # # # # #
#:###:#####:##### ##### # ### # # # ####### # # # #
#:::#:::::::#     #   # # #   # #   #   #   # # # #
###:######### ####### # ### # # # ### # # ### # # #
# #:::#     # #             #   #   # #       #   #
# ###:##### # # ################### ### ### #######
#   #:#   # # # #   #   #   #       #   # #       #
### #:# # # # # ### ### # # # ### ### ### # #######
#:::::# #   # #   # #   # # # #     # #   #       #
#:##### ##### ### # # # # # # ##### # # ######### #
#:#:::#   #:::::# #   # # # #   # #   #       #   #
#:#:#:### #:###:# ##### # # ### # ########### # ###
#:::#:#   #:# #:#       # #     # #     #   # #   #
#####:# ###:# #:################# # ### # # # ### #
#    :# #:::  #:::::::::::::::#   #   # # # #   # #
# ###:# #:######### #########:# ####### # # ### # #
# #:::#  :::::::#   #       #:::::::::# # #     # #
# #:###########:# ##### ### #########:# # ####### #
# #:::::::::#:::#     # #   #   #   #:  #         #
# ### #####:#:##### # # ##### # ### #:########### #
#   # #   #:::#   # # #     # #   #:::#           #
# # ### # ##### ### # ### # # ### #:###############
# # #   #   #   #   #   # # # #   #:# #       #   #
### # ##### # ### # ##### ### # ###:# # ### # # # #
#   # #   #   # # # #     #   # # #:#   #   # # # #
# ### # # # ### # ### ##### ### # #:##### ##### # #
# #   # # # #   # #   #     # #   #:::::  # #   # #
# # ### # # # # # # ### ##### #########:### # ### #
#     # # #   # #   #   #     # #   #  :::  # #   #
####### # ##### # ### ### ### # # # # ###:### #####
# #     #     # #   # #   #   #   # #   #:::#     #
# # ######### # ##### # ### ##### # # #####:##### #
#   #   #   #   #     #   #     # #   #   #:::::# #
####### # # # ### ####### ##### # # ### # #####:# #
#         #   #   #       #       # # # # # #:::# #
# ############# ##### ########### # # # # # #:### #
#       #     # #     #   #   #   #   # # # #:::# #
### ##### ### # # ### # ### # ######### # # ###:# #
#   # #   #   # #   #     # #     #   # # #   #:# #
# ### # ### ### ######### # ##### # # ### ### #:# #
# # # # # #     #         #   # #   #       # #:  #
# # # # # # # ### # # ####### # ####### ### # #:###
#     #   # #     # #         #           #   #:::G
###################################################
