###################################################
S   #     #                 #         #   #   #   #
# ### ### # ############### ##### ### # # # # ### #
#   #   # #     #   #       #     #   # # # # #   #
### ##### # ##### # # ####### ##### ### # # # # ###
# # #         #   #   #       #   #   # #   #     #
# # # # ##### # ####### ### ### # ### ########### #
# #   #   #   # # #     #   #   #   #   #     # # #
# ##### # # ### # # ##### # # ##### ### # ### # # #
#       # # #       #     # #     # #     #       #
########### ####### # ##### ####### # ### #########
#     #   #   #     #   #   #       # #   #   #   #
### # # # ### ######### # ### ####### # ### # # # #
#   # # #   # #   #   # # # #   #     # #   #   # #
# # # ##### # # # ### # # # ### # ##### ### ##### #
# # #   #     # #   #   #   #   # #     #   # #   #
# # ### # ##### ### # ####### ### ####### ### # ###
# #   # #   #   # # #       #   #   #     #   #   #
# ### # ### ### # # ####### ### ### # ##### ##### #
# #   #   #   #   #     #       #   # #   # #   # #
# # # # ##### ### # ### ####### # # ### # # # # # #
# # # #     # #   # # #   #   # # # #   # #   #   #
### ### ##### ##### # # # # # # # ### ### ### #####
#   #   #     #     # # # # # # # #     #   #     #
# ### # # # ### ##### # # # # # # # ####### ##### #
#   # # # #   # #   #   #   # # #   # #   #       #
##### # # ##### ### ######### ####### # # ####### #
#     # #     #   #       #   #   #   # # #   #   #
# # ######### # # ####### # ### # # # ### # # #####
# #       #     # #       #   # # # #   # # # #   #
# ##### # # ##### # ########### # ##### # # # # # #
# #   # # # #     #       #     # #     #   # # # #
# ### ### ### # ######### # ##### # ######### # # #
#   #         # #         # #   # #     #     # # #
### ####### ### # ######### # # # ### # # ##### ###
#     #   # #   #   # #   # # # #   # # #     #   #
##### # # # # # ### # # # # # # # # # ### # ##### #
#   # # # # # #       # #   # # # # #     #     # #
# ### # # # ######### # ##### # ### ####### ### # #
#   #   # # #   #   # # #     # #   #     # #   # #
# # ### # # # # # # # # # ### # # ####### # # ### #
# #   # # #   # # #   #   #   # #     #   # # #   #
# # # ### ##### ######### # ######### # ### # # ###
# # # #   #   #   #       # #     #     #   # # # #
# ### # ### # # # # ####### # ### # ### # ### # # #
# #   #     # # # # #   #   #   # # # #     #     #
# # ######### ### # ### # # ##### # # ##### # #####
# #   #     #   # #   #   # #     #   #   # # #   #
# # ### ### ### # ### ### ### ######### # # ### # #
# #       #     #       #     #         #       # G
###################################################
