###################################################
S:::#   #     #   #   #     #   #   #     #     # #
# #:### # ### # ### # # ### # ### # # ### # # # # #
# #:::::# #   #  :::# #   # # #   # #   #   # # # #
# #####:# # #####:#:# ### # # # ####### # ### # # #
# # #:::# #     #:#:#     # # # #     # # #   #   #
# # #:######### #:#:####### # # # ### # ### #######
#   #:#:::#:::# #:#:::#   #   #   #   #   # #   # #
#####:#:#:#:#:# #:# #:# # ### ##### ##### # # # # #
#    :::#:::#:#:::# #:# # #   #     #     # # # # #
# ###########:#:### #:# # # ### ##### ##### # # # #
#   #       #:::# # #:# #     # #   # #     # # # #
# # ####### ##### # #:# ##### # # # # # ### ### # #
# #         #:::#   #:# #     #   #   #   #     # #
# ######### #:#:#####:# # ############# # ### ### #
# #     #   #:#:::::#:# # #             #   #     #
# # # # # ###:#####:#:# # # ####### ##### #########
# # # # # # #:::# #:::# # # # #   # #   # #     # #
# ### ### # ###:# ##### # # # # # # # ### # ### # #
#     #   #    :# #     # # #   # #   #     # #   #
####### #######:# # ### # # ##### ##### ##### ### #
#       #:::::::# # #   # #     # #     #   #     #
# ##### #:####### # # ##### ### # ### # # # # ### #
#   # # #:::#:::#   #         #   #   # # # #   # #
### # # ###:#:#:##### ####### ##### # # ### ### # #
# # # # # #:::#:    #   #   # #   # # # #   #   # #
# # # # # #####:####### # # ### # ### # # ####### #
#   #   #  :::#:#     #   # #   #     # # #       #
# #########:#:#:# ### ####### ######### # #########
# #  :::#:::#:::  # # #       #       # #         #
# ###:#:#:######### # # # ########### # ### ##### #
# #:::#:#:  #   # #   # #     #     # #     #     #
# #:###:#:# # # # ##### ##### # ### # ####### #####
# #:::#:#:#   #   #   #   # #   #   # #       #   #
# ###:#:#:######### ##### # ### # ### # ##### ### #
# #:::#:#:::#   #     #     #   #   # # #   # #   #
###:###:###:# # # ### # ##### ##### # # # # ### ###
#:::#:::#:::# # # #     #   #     #   # # #     # #
#:###:###:##### # # ### ### ########### # ####### #
#:# #:#:::      # #   # #     #   #   #   #   #   #
#:# #:#:######### ### ### ### # # # # ##### ### ###
#:# #:::# #       #   #   #   # #   #     #       #
#:# # ### # ######### # ####### ######### # ##### #
#:  # # #   #:::::::#   #   #   #:::#:::# #     # #
#:### # # # #:#####:##### # # ###:#:#:#:# ####### #
#:# # # # # #:::::#:::::# # # #  :#:::#:#   #     #
#:# # # # # #####:#####:### # ###:#####:##### #####
#:#   #   # #:::#:#   #:::#:::::#:::#  :::::#   # #
#:###########:#:#:# # ###:#:###:###:#######:### # #
#:::::::::::::#:::  #   #:::#  :::::      #:::::::G
###################################################
