###################################################
S #   # #     # #         #       #             # #
# # # # # ### # # ####### # ##### # ########### # #
#   #   #   #   #   #     #     # #     #       # #
### # ##### # # ##### ########### # ##### ##### # #
# # #   #   # #       #   #       # #         # # #
# # ### ##### # ####### # ### ##### # ######### # #
# #   # #     #       # #     #     # #       # # #
# ### # # ########### # ####### # ### # ##### ### #
# #   #   #       #   #         #   #   #   # #   #
# # ####### ##### # # # ########### ##### # # # ###
#         # #   #   # #       #   # #     # # #   #
######### # ### ####### ##### # # # # # ### # ### #
#         # #   #     #   # #   # # # # # #   #   #
# # ####### # # ### # ### # ##### # ### # ##### ###
# #   # #   # #     #     # #     #   #   # #   # #
# # # # # ### ####### ### # # ####### ##### # ### #
# # #   #     #   #   #   # #   #     #     #   # #
# # ### ##### # # # ####### # # ####### ### ### # #
# #   #   # #   # #       # # # #       #   #   # #
# ####### # # ### ####### # # ### ####### ### # # #
# #   # #   # #   #     # # #   # #     #     #   #
# # # # ### # ### # # # # # ### # ##### ### #######
#   #     # # #   # # # # #     #     #           #
######### ### # ### ### ############# #############
#     #   #   #   #   #             #   #         #
# ### # ### ### # ### ### ######### # # ######### #
#   # # #   #   #   #   #   #     #   #   #       #
### # ### ######### ### # # # ### ### ### # #######
#   #     #       # #   # # #   # #   #   #     # #
# ####### # ##### # # ### ##### # # ### ####### # #
#       # #     #   # # # #     #   #   #   #     #
### ### # ##### ### # # # # ########### # # # #####
#   #   #   # # #     #   # #   # #   #   # #   # #
# ### ##### # # ##### ####### # # # # ### # ### # #
#   # #   #   #     #   #     #   # #   # #   #   #
##### # # ######### # # # ##### # # ### ### # ### #
#       # #   #     # #   #   # # # #     # #     #
# # ####### # # ##### ####### # # # # ### ####### #
# # #     # #   #   # #     #   # # #   #   #     #
# # # ### ####### # ### ### ##### # ####### #######
# #   #   #     # #     # # #   # # # #   #   #   #
# ### # ### ### # ### ### # # # # # # # # # # ### #
#   # #   # # # # # # # #     # # #   # # # #   # #
### ##### # # # # # # # ####### # # ### # ### # # #
# #   # # # # # # #   #     #   # # #   #   # #   #
# ### # # # # # # ##### ##### ### # # ##### ##### #
# #     # # # # # # #   #     #     # #   # #   # #
# ####### # # # # # # ##### ### ### # # # ### # # #
#           #   #     #         #   #   #     #   G
###################################################
