#################
S:::#  :::#:::# #
###:# #:#:#:#:# #
# #:# #:#:::#:# #
# #:###:#####:# #
# #:::::  #:::  #
# ### ### #:#####
# #   #   #:    #
# # ### ###:#####
#   #   #:::#:::#
##### # #:###:#:#
#     # #:::#:#:#
# ##### ###:#:#:#
#   #   #:::#:#:#
### # ###:###:#:#
#   #   #:::::#:G
#################
