#################
S # #   # #   # #
# # # # # # # # #
# #   #     #   #
# ######### #####
#     # #       #
### # # # #######
#   # #   #     #
# ##### ### ### #
#       #   #   #
# # # ### #######
# # #   #   #   #
# # ### ### # # #
# #   #   #   # #
# ### ######### #
#   #           G
#################
