#################
S   #   #   #   #
### ### # # # # #
# #   #   #   # #
# # # # ####### #
#   #   #       #
############### #
#     #   #   # #
# # ### # ### # #
# #     #     # #
# ######### ### #
# #       # #   #
# ####### # # ###
#       # # #   #
# ##### # # ### #
#     #   #     G
#################
