#################
S:::    #   #   #
###:### ### # # #
#:::#     # # # #
#:### ### # # # #
#:  #   # # # # #
#:##### # # # # #
#:#     #   # # #
#:# ### ####### #
#:#   # #   #   #
#:##### # # # ###
#:::::#   #   # #
### #:######### #
#   #:#     #:::#
# ###:# #####:#:#
#   #:::::::::#:G
#################
