#################
S   #         # #
### ##### ### # #
# #     # #   # #
# ##### # # ### #
#   #     # #   #
### # ##### # ###
# #     #   #   #
# ####### ##### #
#         #     #
##### ##### # ###
#   #       # # #
# # ### ##### # #
# #   #   # #   #
# ####### # ### #
#         #     G
#################
