#################
S:#         #   #
#:######### # # #
#:::::::#   # # #
#######:# ### # #
# #    :#     # #
# # # #:####### #
#   # #:::::::# #
##### #######:# #
#   #   #   #:  #
# ##### # # #:###
# #     # # #:  #
# # ##### # #:###
# #     # # #:::#
# ##### # #####:#
#       #      :G
#################
