#################
S:::#     #:::# #
# #:### ###:#:# #
# #:::#  :::#:  #
# ###:###:###:###
# # #:::::  #:::#
# # ### #######:#
#   #   #      :#
##### #########:#
#   #   #:::::::#
# ##### #:#######
# #   # #:::::::#
# # ### #######:#
# #   #   #   #:#
# # # ### # ###:#
#   #     #    :G
#################
