#################
S   #     #     #
### ##### # ### #
# #     #   # # #
# ### # ##### # #
# #   #       # #
# # ### ####### #
# #   # #       #
# ##### # #######
#         #     #
### ##### # # # #
#   #       # # #
# ############# #
#   #     #     #
### # ##### # ###
#   #       #   G
#################
