#################
S       #     # #
##### # # ### # #
#     # # #   # #
# ##### # # ### #
# #   # # #     #
# ### # # ##### #
# #   # # #     #
# # # # # # #####
#   # #   # #   #
# ### ##### # # #
# #   #   # # # #
# # ### # ### # #
# #   # #     # #
# ### ######### #
#   #           G
#################
