#################
S:::    #     # #
###:##### # # # #
#:::# #   # #   #
#:### # #########
#:#:::#       # #
#:#:#:##### # # #
#:::#:#     #   #
### #:# # #######
#   #:# # #     #
# ###:# # # ### #
#   #:  # #   # #
### #:##### # ###
#   #:::::# #:::#
# #######:###:#:#
#       #:::::#:G
#################
