#################
S:::::          #
#####:######### #
#   #:::::    # #
# # ### #:##### #
# #     #:::::# #
# ###########:# #
# #   #     #:# #
# # # # ### #:###
#   #   #   #:::#
# ######### ###:#
# #   #     # #:#
# # # # ##### #:#
#   # # #   # #:#
##### # ### # #:#
#     #     #  :G
#################
