#################
S     #         #
# # # # ####### #
# # # # #       #
### # # # #######
#   #   # #     #
# ##### # # ### #
# #     # # #   #
# ### ### # ### #
#   #   #   #   #
### ### ##### ###
# #   # #   #   #
# ##### # ##### #
# #     # #     #
# # ##### # #####
#         #     G
#################
