#################
S     #       # #
### # # ##### # #
# # #       #   #
# # ####### #####
#   # #   #     #
##### # # ### # #
#   #   # #   # #
# # ##### # ### #
# # #   #     # #
### # # # ##### #
#   # # #     # #
# ### # ##### ###
# #   #     #   #
# ####### # ### #
#         #     G
#################
