#################
S:#     #       #
#:# ##### ##### #
#:::::::# #   # #
# ### #:# ### # #
# #   #:# #   # #
# #####:# # # # #
#     #:#   # # #
##### #:##### ###
# #   #:::::#   #
# # ##### #:### #
# # #   # #:#   #
# # # # ###:# ###
# #   #   #:  # #
# # ##### #:### #
#   #     #:::::G
#################
