#################
S               #
##### ##### ### #
#   #   #   #   #
# ##### # #######
# #   # #   #   #
# # # # ### # # #
#   #   # #   # #
##### # # ##### #
#     #   #   # #
# # ####### ### #
# #   #       # #
# ##### ##### # #
# #   # #   # # #
# # # # # # # # #
#   #   # #   # G
#################
