#################
S:::::::::::::  #
########### #:###
#           #:::#
###############:#
#       #  :::::#
# ##### # #:#####
#     #   #:#:::#
###########:#:#:#
#     #   #:::#:#
# ### # ##### #:#
# #   #       #:#
# # ###########:#
# #   #      :::#
# ##### ### #:###
#       #   #:::G
#################
