#################
S     #         #
### # # ### #####
#   # #   # #   #
# ####### # # # #
#     #   # # # #
# ### ### # ### #
# # #     # #   #
# # ####### # ###
# # #       #   #
# # # ######### #
#   #         # #
####### ##### # #
#       #   # # #
# ####### # # # #
#         # #   G
#################
