#################
S:::#       #   #
###:# ####### # #
#:::#   #     # #
#:##### # ##### #
#:#   #   # #   #
#:# # ##### # ###
#:# #    :::#:::#
#:# #####:#:#:#:#
#:# #:::#:#:#:#:#
#:# #:#:#:#:#:#:#
#:# #:#:::#:::#:#
#:# #:#########:#
#:# #:::# #   #:#
#:#####:# # # #:#
#:::::::#   #  :G
#################
