#################
S:::::# #   #   #
# ###:# # # ### #
# #  :::::#   # #
# #######:### # #
#     #  :::#   #
####### ###:#####
#   #     #:::::#
# ### #########:#
#       #     #:#
####### # #####:#
#     # #   #:::#
# ### # ### #:###
# #   # # #  :::#
# # ### # #####:#
# #       #    :G
#################
