#################
S #       #     #
# ####### # #####
#       # # #   #
# # # ### # # # #
# # #     # # # #
# # ####### # # #
# #       #   # #
# ##### # ##### #
#   #   # #   # #
##### ### # # # #
#   #   #   # # #
# # ### # ### # #
# #   # # #   # #
# ##### # # ### #
#       # #     G
#################
