#########
S:#   # #
#:### # #
#:::# # #
###:# # #
#:::# # #
#:### # #
#:::::::G
#########
